@sep ==== 
one tags 1


@tags days, qq

grüßen ==== здороваться
gucken ==== смотреть

@@tags days, qq

#Nomen

der Abstellraum ==== кладовая
der Bart ==== борода
der Briefkasten ==== почтовый ящик
die Couch ==== диван
das Dach ==== крыша
#Nomen
die Einrichtung ==== обстановка, мебель
die Hausordnung ==== правила дома
die Gaststätte ==== ресторан, кафе
die Innenstadt ==== центр города@
der| Lärm ==>==< шум>
die Miete ==== арендная плата
die Mülltonne ==== мусорный бак
die Nähe ==== близость
die Neuigkeit ==== новость
der Rasen ==== газон
das Recht ==== право
die Reinigung ==== уборка
die Rente ==== пенсия
die Rücksicht ==== внимание, Rücksicht|
der Schmutz ==== грязь
die Sicherheit ==== безопасность
der Staub ==== пыль
die Störung ==== нарушение, помеха
das Treppenhaus ==== лестничная клетка
die Vorschrift ==== предписание, правило
die Wirtschaft ==== экономика, хозяйство


@tags hello world


// hello
// world

#Verben
abschließen ==== закрывать, заключать
annehmen ==== принимать, предполагать
beruhigen ==== успокаивать
beschweren ==== жаловаться, обременять
einziehen ==== вселяться, въезжать
entsorgen ==== утилизировать, выбрасывать
füttern ==== кормить
gießen ==== поливать
klingeln ==== звонить
lassen ==== оставлять, разрешать
leihen ==== одалживать
pflegen ==== ухаживать, заботиться
reinigen ==== чистить, убирать
sinken,steigen ==== опускаться,подниматься
trennen ==== разделять, отделять
vermeiden ==== избегать
##Verben

#Adjektive

anwesend ==== присутствующий
ärgerlich ==== раздражающий, злой
ernst ==== серьезный
faul ==== ленивый
notwendig ==== необходимый
ständig ==== постоянный


##Adjektive

@tags hello, world
@tags day,today,guten,abbend

one tags 2
one tags 2
@@tags day,today
one tags 2
#Andere Wörter

@sep --

ebenfalls -- также
einerseits, andererseits -- с одной стороны, с другой стороны
erstens, zweitens, drittens -- во-первых, во-вторых, в-третьих
im Freien -- на свежем воздухе
mittlerweile -- тем временем
sowohl, als auch -- как..., так и...
weshalb -- почему
zumindest -- по крайней мере

##Andere Wörter
Nomen3